XXXXXXXXXXXXXXXXXXXX
X~~~~~~~~~P~~~~~~~~X
X~~~~~~~~~~~~~~~~~~X
X~~~~A~~~~~~~~~~~~~X
X~~~~~~~~~~~~~~~~~~X
X~~~~~~~~~~~~~~A~~~X
X~~~~~~~S~~~~~~~~~~X
X~~~S~~~~~~~~~~S~~~X
X~~~~~~~~~~~~~~~~~~X
X~~~~~~~~~~~~~~~~~~X
X~~~~L~~~~~~~~~~~~~X
X~~~~~~~~~~~~~~~~~~X
X~~~~~~~~~~~~~~~~~~X
X~~~~~~~~~~~~~~~~~~X
X~~~~~~~~~~~~~~L~~~X
X~~~~~~~~~~~~~~~~~~X
X~~~~~~~~~~~~~~~~~~X
X~~~~~~~~~~~~~~~~~~X
X~~~~~~~~L~~~~~~~~~X
XXXXXXXXXXXXXXXXXXXX