XXXXXXXXXXXXXXXXXXXX
X~~~~~~~~~P~~~~~~~~X
X~~~~~~~~~~~~~~~~~~X
X~~~~A~~~~S~~~~~~~~X
X~~~~~~~~~~~~~~~~~~X
X~~~~~~~~~~~~~~A~~~X
X~~~~~~~~~~~~~~~~~~X
X~~~S~~~~~~~~~~S~~~X
X~~~~~~~~~~~~~~~~~~X
X~~~~~~~~~~~~~~~~~~X
X~~~~~~~~~~~~~~~~~~X
X~~~~~~~~~~~~~~~~~~X
X~~~~~~~~~~~~~~~~~~X
X~~~~~~~~~~~~~~~~~~X
X~~~~~~~~~~~~~~~~~~X
X~~~~~~~~~~~~~~~~~~X
X~~~~~~~~~~~~~~~~~~X
X~~~~~~~~~~~~~~~~~~X
X~~~~~~~~~~~~~~~~~~X
XXXXXXXXXXXXXXXXXXXX