XXXXXXXXXXXXXXXXXXXX
X~~~~~~~~~P~~~~~~~~X
X~~~~~~~~~~~~~~~~~~X
X~~~~~~~~~~~~~~~~~~X
X~~~~~~~~~~~~~~~~~~X
X~~~~~~~~~~~~~~~~~~X
X~~~~~~~~~~~~~~~~~~X
X~~~~~~~~~~~~~~~~~~X
X~~~~~~~~~~~~~~~~~~X
X~~~~~~~~~~~~~~~~~~X
X~~~~~~~~~~~~~~~~~~X
X~~~~~~~~~~~~~~~~~~X
X~~~~~~~~~~~~~~~~~~X
X~~~~~~~~~~~~~~~~~~X
X~~~~~~~~~~~~~~~~~~X
X~~~~~~~~~~~~~~~~~~X
X~~~~~~~~~~~~~~~~~~X
X~~~~~~~~~~~~~~~~~~X
X~~~~~~~~~~~~~~~~~~X
XXXXXXXXXXXXXXXXXXXX