XXXXXXXXXXXXXXXXXXXX
X~~~~X~~~~P~~X~~~~~X
X~~~~~~~~~~~~X~~~~~X
X~~L~S~~~~~~~~~~~~~X
XXXXXX~~A~~~~~~~~~~X
X~~L~X~~~~~~X~~A~~~X
X~~~~X~~~~~~X~~~~~~X
X~~~S~~~~~~~~~~S~~~X
X~~~~~~~~~~~~~~L~~~X
XXXXX~~~~~XXXXXXXXXX
X~~~X~~~~~~~X~~~X~XX
X~~~S~~~~~A~XL~~~~~X
X~~~~~~~~~~~~~~~~~~X
X~~~~~~~XXXXXXXXXXXX
X~~~~~~S~~~~~~~~~~~X
X~~~~~~~~~~~~~~~~~~X
X~~~~~~~~~~~~~~~~~~X
X~~~~~~~~~~~~~~~~~~X
X~~~~~~~~~~~~~~~~~~X
XXXXXXXXXXXXXXXXXXXX