XXXXXXXXXXXXXXXXXXXX
X~~~~~~~S~P~S~~~~~~X
X~~L~~~~S~~~S~~~~~~X
XXXX~~~~SS~SS~~~~~~X
X~A~~~~~~~~~~~XXXXXX
X~~~~~~~~~~~~~XA~~~X
X~~~~XXXXX~~~~X~~~~X
X~~~SXL~~X~~~~~S~~~X
X~~~~XX~XX~~~~~~~L~X
X~~~~~~~~~~~~~~XXXXX
X~~~~L~~~~~~~~~~~~~X
XX~~~~~~~~~~~A~~~~~X
X~~~~~~~~~~~~XXXXXXX
XXXXX~~~~~~~~X~~S~~X
X~~~S~~~~~~~~~~~~~~X
X~~~~~~S~~~~S~~~~~~X
XSSS~SS~SS~~SS~~SSSX
X~~~~~~~~~~~~~~~~~~X
X~~~~~~~LLL~~~~~~~~X
XXXXXXXXXXXXXXXXXXXX