XXXXXXXXXXXXXXXXXXXX
XOOOOOOOOOOOOOOOOOOX
XOOOOOOOOOOOOOOOOOOX
XOOOOOOOOOOOOOOOOOOX
XOOOOOOOOOOOOOOOOOOX
XOOOOOOOOOOOOOOOOOOX
XOOOOOOOOOOOOOOOOOOX
XOOOOOOOOOOOOOOOOOOX
XOOOOOOOOOOOOOOOOOOX
XOOOOOOOOPOOOOOOOOOX
XOOOOOOOOOOOOOOOOOOX
XOOMOOOOOOOOOOOOOOOX
XOOOOOOOOOOOOAOOOOOX
XOOOOOOOOOOOOOOOOOOX
XOOOOOOOOOOOOOOOOOOX
XOOOOOOOOOOOOOOOOOOX
XOOOOOOOOOOOOOOOOOOX
XOOOOOOOOOOOOOOOOOOX
XOOOOOOOOOOOOOOOOOOX
XXXXXXXXXXXXXXXXXXXX